111111111111111111111
10000C00C1000N00N0C01
1100N0P00E1000C1000N1
11000C0001000N000C001
10000000C00000C0N0011
111111111111111111111